1111111111111111111111111111111111111111111
1C0000001000C0000CCCCCCCCCCCCCCCCCCCCCCCCC1
100000000100C000000000000000000000000000001
1C000000000000000E0000011111011111000000001
111111110111000111000001CCCCCCCCC1000000001
1111100001110P0111000001CCCCCCCCC1000000001
111110000111000111000001CCCCCCCCC1000000001
1111111111111111111111111111111111111111111