1111111111111111111
1C000000P100C0000C1
100000000100C000001
1C000000000000000E1
1111111101111111111
1111100001111111111
1111100001111111111
1111111111111111111