1111111111111111111
1C0000001000C0000C1
100000000100C000001
1C000000000000000E1
1111111101110001111
1111100001110P01111
1111100001110001111
1111111111111111111