11111111111111111111111111111111111111111
1C000000000000000000P000000000000000000C1
11111101111111111111111011111111111111101
1C000000000000000000000000000010000000101
11101111111011110111011111111010101110001
1C1M1000000000C111E111C000000000100011111
10100011111011110000011111111011111000001
10101000000000011000110001000010001111101
1000101111111100000000010001100010000C101
10101000000001111111011111110011111111101
101C111110110000000000000C100000000000101
1011100000111111111C1110111C1001111101101
1000001110000000001110000011110000C100001
1010111C111101111000001010100M01111101111
10001M0000000000101010101000100010C100001
10101011111101101C101C1C10101010000111101
10100000000000101111111110111111111110101
10101111111010100100000000100000100000001
10101000000010000101111111100000101111111
10001111111111110101000000001110100000001
10100000000000010101001111111010111111101
10110111111111010101001000000010100000001
10000000100010000101001011111010101111111
10111110101000111101001010001010100CCC001
101C0000001010000101001000001010111111101
101111101111101111M1001111111010100000001
10000000100000000101000000000010101111111
10111111111111010101111111111110100010001
101C0000000000010100000000000000101000101
10111011111111011111111101110111111111101
1C00M00000000000000000000C1C0000000000001
11111111111111111111111111111111111111111